%%%%%%%%%%%%%%%%%%%%%%%%%%%%%%%%%
%?                  ?           %
%%%% %%%%%%%%%%%%%%%%%%%%%%%%%% % 
%                               %
% %%%%%%%%%%%%%%% %%%%%%%%%%%%% %
%                 #             %
%%%%%%% %%%%%%%%%%%%%%%%%%%% %%%%
%?                              %
%%%%%%%%%%%%%%% %%%%%%%%%%%%%%%%%
%                               %
% %%%%%%%%%%%%%%%%%% %%%%%%%%%% %
%                     % ?       %
%%%%%%%%%%%%%%%%%%%%%%%%%%%%%%%%%